9|9|1|2|3|
111101111
100001221
103301221
150501221
000600000
1000h0001
100gg0501
104000001
111101111|
111101111
100001221
1033k21
100001221
000600500
100000001
104000501
100000001
111101111|
111101111
100001221
103301221
100001221
100000001
104000501
100050001
111101111