9|9|1|2|3|
111101111
100001221
103301221
100001221
000000000
100000001
100000501
100000001
111101111|
111101111
100001221
103301221
100001221
000000500
100000001
100000501
100000001
111101111|
111101111
100001221
103301221
100001221
000000500
100000001
100000501
100050001
111101111