9|9|
111011111
100001221
103301221
100001221
000600000
100000001
104000501
100000001
111011111