9|9|1|2|3|
111101111
100001221
103301221
100001221
000600000
100000001
100000501
104000001
111101111|
111101111
100001221
103301221
100001221
000600500
100000001
104000501
100000001
111101111|
111101111
100001221
103301221
100001221
000600500
100000001
104000501
100050001
111101111