9|9|
111111111
100001221
103301221
100001221
100600001
100000001
104000501
100000001
111111111